VBP+RB	VBP
VBZ+RB	VBZ
IN+DT	IN
MD+RB	MD
VBD+RB	VBD
JJ+CC+DT	JJ
IN+WDT+NN	IN
NN+NN	NN
PDT+DT	PDT
IN+NN	IN
RB+IN	RB
DT+JJR	RB
DT+JJ	RB
RP+IN	IN
NN+CC+JJ	NN
RB+RB	RB
IN+:+CD	JJ
VBD+VB	VBD
JJ+NN	NN
DT+NN	RB
VBG+TO	IN
RB+PDT	PDT
JJ+IN	IN
IN+JJS	RB
IN+CC+IN	RB
NN+IN+NN	NN
JJ+:+VBN	VBN
IN+IN	IN
VBN+:+RB	JJ
VB+IN	IN
NN+:+NN+:+JJ	JJ
FW+.	FW
PRP$+CC+PRP$	PRP
CD+.	CD
NNS+TO	IN
JJ+:+NN	JJ
NNP+NNPS	NNPS
MD+VB	MD
RB+:+VBD	VBN
CD+:+CD	CD
NN+:+VBN	VBN
CC+NNP+.	NNP
CD+DT	PRP
NN+:+TO+:+NN	RB
NNP+.	NNP
RB+VB	RB
DT+RP	RB
CD+JJR	NN
CD+RBR	NN
IN+:+NN	JJ
JJ+NNS	NNS
NN+:+JJ	JJ
IN+TO	IN
JJ+TO	IN
IN+JJ	RB
DT+JJ+NN	RB
NN+:+JJR	RB
RB+RB+IN	IN
NNS+VBZ	JJ
IN+JJ+IN	IN
IN+:+DT+:+NN	JJ
VBP+TO	IN
RP+:+CC+:+IN	RB
RP+TO	IN
RP+CC+VBN+IN	RB
VB+:+RP	NN
CC+NNP	NNP
NN+:	NN
RP+:+DT+:+NN	JJ
TO+NN	RB
NN+:+NN	NN
RB+:+VBN	VBN
NNP+NNP	NN
NN+:+IN+:+NN	NN
NNP+:+VBN+:+RB	RB
FW+JJ	RB
VBG+:+VB	NN
DT+JJS	JJS
IN+:+NNS	NNS
DT+RB+JJ	JJ
NNP+VBZ	JJ
FW+:+NN	NN
NN+:+IN	NN
CC+RB	RB
DT+DT	DT
IN+NN+IN	IN
NN+IN	IN
VBG+:+IN	NN
NN+:+VBD	VBD
WP+IN	WP
NNS+NN	JJ
NN+:+DT	NN
JJ+:+DT	NN
CD+.+LS	CD
NNP+NNS	JJ
NN+.	NN
IN+NN+TO	IN
IN+NNS	NN
RBR+IN	RBR
DT+:+NN	JJ
IN+RB+IN	IN
IN+DT+NN+VBG	RB
RB+IN+DT	RB
JJ+:+JJ	JJ
IN+:+RB	JJ
RP+:+RB	JJ
JJ+:+VBG	NN
WRB+:+TO	NN
NNP+CC+NNP	NNP
VBZ+JJ	VBZ
VB+:+IN	NN
RB+TO	IN
UH+RB	RB
VBD+JJ	VBD
VBP+:+NNS	NNS
DT+RBS	RBS
NN+IN+DT	JJS
JJR+IN	RBR
VB+:+RB	NN
RB+JJ+IN	IN
NN+NNS	NNS
IN+:+VBN	VBN
IN+CD	RB
RB+:	JJ
IN+RB	RB
TO+VB+IN	RB
VBZ+VB	VBZ
VB+VBZ	VB
VBP+JJ	VB
CD+CC+RBR	CD
DT+VBZ	IN
DT+CD	NN
IN+RB+RB	RBR
LS+:	LS
NN+:+VBZ	NNS
RP+:+DT+:+RB	JJ
PDT+DT+RBR	RB
IN+:	IN
RB+JJR	RB
JJ+CC+JJ+NNS	JJ
VBZ+NN	VBZ
RB+:+JJ	RB
NNS+JJ	JJ
VB+RP	VB
DT+NN+IN	DT
RB+:+IN+:+NN	JJ
NNP+:+IN	NN
IN+DT+NN	RB
IN+UH	RB
RB+:+TO+:+NN	JJ
VBN+:+IN+:+DT+:+NN	JJ
WP+VBZ	IN
NNP+NN	NN
RBR+RB	RBR
NN+VBZ+NN	RB
JJ+CC+JJ	JJ
DT+CC	DT
VBN+IN	IN
PDT+DT+NN	RB
NNS+:+IN	JJ
PRP+NNP	NNP
NN+:+RP	NN
VB+RB	VB
TO+VB	VB
VB+JJ	VB
CC+RB+IN	RB
DT+RB	RB
DT+NNS	DT
NN+VBZ	JJ
NN+TO	IN
DT+:	DT
FW+:+JJ	JJ
JJ+:+IN	NN
VB+:+NNS	NNS
CC+NNS	NNS
NN+:+IN+:+RB	RB
JJ+:	JJ
VB+NNS	VB
MD+:+VB	JJ
NN+:+RBR	RBR
NN+:+NNS	NNS
FW+FW	FW
IN+DT+RB	RB
NN+:+VBG	NN
VB+CD+.	CD
NN+:+NNP	JJ
NNP+:+DT+:	NNP
VBN+RP	VBN
IN+NNP	JJ
JJ+:+NNPS	NNS
CD+NNS	NNS
RB+JJS	RB
RB+DT+JJS	RB
IN+DT+JJS+NN	RB
NNP+NN+NNP+NNP	FW
WRB+IN	WRB
LS+.+CD	CD
VB+:+WRB	NN
VBP+:+WRB	NN
PDT+IN	RB
DT+:+IN	RB
NNP+DT	NNP
NN+:+IN+:+DT+:+NN	JJ
WRB+RB	WRB
RB+TO+VB	RB
CC+WP	WP
NN+:+RB	NN
NN+:+VB	VB
JJ+:+VBZ	VBZ
NNP+RB	NNP
JJ+:+VBD	VBD
NN+:+IN+:+NNS	NN
NN+VB	NN
VB+:+NN	NN
DT+JJ+JJ	JJ
NN+:+IN+:+VBG	NN
JJ+:+LS	JJ
NN+:+FW	JJ
JJ+:+VB	JJ
CD+JJ	CD
CD+NNP	CD
PRP+VBP	UH
IN+PDT	RB
CC+NN	UH
RB+JJ	JJ
WDT+VBZ	IN
CD+NN	CD
VB+PRP	VB
VBP+.	RB
VB+VB	UH
WRB+PRP+VBG	UH
PRP+VB	UH
CD+CD	CD
VB+PRP+VB	VB
JJ+RB	RB
RB+NN	UH
RB+:+TO+:+VB	JJ
CD+:+JJ	CD
NNP+:	NN
VBP+:+VBZ	NNS
VBP+:+NN	NN
JJ+:+NNS	NNS
CD+CC+JJR	CD
CD+:+DT	CD
RP+:+IN+:+NN	JJ
NN+:+CC+:+VB	NN
JJ+:+NNP	JJ
NN+:+CC+:+UH	NN
DT+NNPS	NNPS
NNP+VB+NNP	NNP
NNP+NNP+NNP	NNP
NNP+VBZ+NN	NNP
RBS+RB	RB
NNP+DT+NNP	NNP
NNP+NNP+PRP	NNP
NNP+NNP+VBZ+NN	NN
RB+VBN	VBN
FW+NN	FW
CD+.+LS+NN	CD
VBP+RB+PRP	VBP
MD+JJ	MD
VBD+NN	VBD
NNP+:+VBN	VBN
RP+:+VBN	VBN
NN+IN+CC+NN+RB	RB
NN+:+PDT	NN
CC+WP+VBP+PRP	NN
NNP+NNP+CD	NNP
VB+:	VB
RB+RBR	RB
JJR+IN+JJ	JJR
UH+:+UH	UH
VBP+NN	VBP
JJ+DT	DT
DT+RBR	RB
VB+JJR	VB
VBP+VB	VBP
UH+VB	UH
IN+CC+RB	IN
FW+:+VBN	VBN
RB+DT	IN
NNP+:+NNP	JJ
RB+IN+RB	RB
CC+.+CC	CC
VB+DT	NN
VBP+:	VB
RB+VBZ	RB
NNP+:+VBG	VBG
IN+VBZ	RB
NNS+:+VBN	VBN
NNS+:+JJ	JJ
RP+TO+VB	RB
RP+:+NN	JJ
IN+WDT	IN
UH+.+DT	UH
IN+NNS+IN	IN
NN+CC+VB	NN
VB+CC+VB	NN
RB+:+NN	JJ
IN+VBN+TO	IN
VBG+:+JJ	NN
NNP+NNP+VBZ+NNP	NNP
NNP+VBZ+NNP	NNP
NN+:+NNPS	NNPS
RB+VBD+TO	IN
JJS+NNS	NNS
IN+NNS+TO	IN
RBR+CC+RBR	RBR
CC+FW+FW	FW
VB+RB+:	VB
.+NN+.	LS
.+LS+.	LS
IN+:+VBG	VBG
RP+RB	RB
FW+:	FW
JJ+NNP	VBN
NNP+:+RP	JJ
NN+:+JJS	JJ
NN+JJ	JJ
DT+NN+RB	RB
JJ+VBN	VBN
NN+.+CD	CD
NN+CC+NN	NN
NNS+.	NNP
CD+.+NN	CD
CD+JJ+NN	CD
UH+WRB	UH
WRB+JJ	WRB
MD+IN	MD
NN+VBP	VBP
WRB+VB	WRB
:+.	UH
RP+IN+NNS	RB
JJ+NN+VBZ+NN	NN
JJ+CC+RB+IN	JJ
LS+:+NNP	NN
LS+:+NN	NN
FW+:+VB	RB
NNP+:+NN	NN
JJ+JJ	JJ
NN+IN+DT+NN	NN
RB+IN+DT+NN	NN
NNP+CC+NNP+NNP	FW
WP+DT	WP
NN+:+NNP+NNP	NN
IN+RBS	RBS
NN+VBN	VBN
RB+CC+RB	RB
UH+:+NN	UH
RBS+JJ	RB
DT+NN+NN	RB
NN+.+IN	FW
JJ+:+RP	NN
DT+IN	RB
JJ+CC+RB	RB
IN+DT+VBZ	RB
IN+.	FW
DT+NN+WRB	WRB
IN+NN+IN+NNP	RB
NNP+NNS+IN+NN	RB
NN+TO+NN	RB
VBD+:+NNS	NNS
NN+CC+RB	RB
IN+MD+VB	RB
NN+CD+.	CD
VB+NN	NN
VBP+:+PRP+:+PRP	JJ
VBP+:+RP	NN
FW+:+NNP	NN
PDT+DT+CD	CD
WP+VBZ+RBR	UH
JJR+RP	RB
NNP+IN+NNP	NNP
DT+:+RB	RB
IN+DT+RB+JJS	RB
NNP+:+VB	VB
FW+:+FW	FW
NN+:+UH	RB
JJ+TO+VB	JJ
JJ+:+RB	JJ
RB+:+DT+:+NN	RB
NNP+JJR	NN
DT+$	DT
DT+CC+JJ	NN
NN+JJR	RB
NNP+TO+NNP	NN
NN+TO+NNP	NN
NNP+:+NNS	NNS
DT+PDT	PDT
JJ+VB	UH
CC+WDT	UH
NNP+:+VBZ	NNS
UH+UH	UH
RB+:+IN	NN
NN+:+VBP	VB
IN+:+NNP	NNP
RB+:+RB	JJ
NNP+JJ	NNP
DT+:+NNS	JJ
LS+NN	NNP
RB+IN+NN	RB
RP+:+VB	VB
VBP+:+RB	NN
NN+TO+VB	RB
NN+:+CD	JJ
RP+:+JJ	RB
VBP+NNS	NNS
RB+CC+IN+DT	RB
WP+VBP+PRP+VB	UH
RP+:	RP
VB+:+VB	NN
IN+VBP	RB
VBP+IN	NN
JJ+:+CC+:+NN	JJ
RB+CC	RB
TO+CC+NN	RB
TO+:+NN	RB
RB+:+VBG	JJ
JJR+RB	RB
NNP+:+NNP+VBZ	NNP
NN+RB+RB+JJ+NN	NNP
DT+IN+DT+JJ	RB
WRB+:+VBN	JJ
NNS+NNS	JJ
NN+CD+.+LS	CD
NNP+$	NNP
NN+:+IN+:+JJ	NN
VB+:+CC+:+JJ	JJ
LS+.	LS
NNP+:+JJ	JJ
RP+CC+RP	RB
JJS+NN	NN
IN+CC+JJ	RB
RB+:+TO+:+NNS	NNS
NN+LS+.+CD	CD
NN+:+TO+:+NNS	NNS
NNP+NNS+NNP	NN
NNP+VBZ+NNPS	NNS
JJS+DT	DT
VBZ+DT+JJ	FW
NNS+:+VB	NN
IN+:+JJ	JJ
NNP+CC+NNP+VBZ	NNP
DT+CC+DT	DT
RP+:+NNP	JJ
JJ+:+IN+:+DT	NN
CC+IN	IN
DT+NNP	RB
JJR+:+RB	RB
CD+:+IN+:+CD	RB
VB+:+RB+:+DT+:+NN	JJ
NN+RB	RB
DT+:+IN+:+DT	RB
VB+CD+.+LS	CD
CD+:+NNS	NNS
IN+CC+WRB	WRB
IN+DT+JJR	RB
JJ+:+FW	JJ
NN+:+DT+:+NN	RB
JJ+:+TO+:+VB	JJ
NNP+FW+NNP	NNP
NNP+CC+VB	NN
RB+VBN+TO	IN
JJ+CC+RB+JJS	RB
IN+PRP+VBP	UH
RB+:+CD	JJ
RP+:+IN	JJ
PDT+IN+DT+JJ	RB
CD+.+JJ	CD
VBG+VB	NNP
CD+:+NN	NN
VB+:+RB+:+DT+:+VB	JJ
IN+DT+NNP	RB
DT+IN+RB	RB
JJ+NN+TO	RB
VBD+RP	VBD
DT+:+UH	UH
VBP+:+DT	NN
RB+:+RP	NN
NNPS+.	NNP
RP+IN+NN	RB
NNS+:+RP	JJ
VBZ+:+IN	NNS
NN+IN+NN+IN	RB
IN+JJ+NNS	RB
NN+CD	CD
CD+:+LS	CD
VBG+NN	NN
UH+:	VB
.+NN	FW
NNS+VBG	NN
CD+IN+CD	RB
IN+VB	RB
IN+DT+NN+IN	IN
.+DT+.	LS
VBN+:+JJ	JJ
IN+.+RP	RB
CC+FW	FW
IN+RB+VBG	IN
VBP+NNP	FW
NN+:+RBS	JJ
RB+:+JJS	JJ
DT+IN+DT	RB
NNP+:+FW+:+NNP	FW
RB+:+DT	RB
PDT+DT+IN	RB
DT+NNP+NNP	NNP
FW+FW+FW	FW
NN+CC+NNS	NNS
VBD+:+VBZ	NNS
JJS+:+NNS	NNS
NNP+NNS+IN+NNP	NNP
NN+NNP	NN
NNP+:+VBD	VBD
VBN+:+IN+:+NN	JJ
NN+RP	RB
PRP+PRP$	PRP
RBS+IN+DT	RBS
DT+UH	UH
RB+JJR+IN	RBS
PDT+IN+DT	RB
IN+CC+RB+IN	WRB
VBZ+:+DT	JJ
PRP+RB	UH
CD+.+LS+RB	CD
RB+IN+NNS	RB
JJ+RP	JJ
JJS+IN+DT	JJS
NN+:+FW+:+NN	JJ
PRP$+NNP	UH
PRP+PRP	PRP
DT+VB	NN
PRP$+NN	UH
JJSS+NN	NN
FW+NNP	NNP
NN+IN+NNS	NN
IN+:+DT+:+NNS	JJ
JJ+:+TO+:+NN	JJ
NNP+NN+NN+NN+NNP	NNP
NNP+:+RB	NN
DT+FW	DT
DT+:+DT	DT
WRB+NNS+IN	WRB
IN+PRP+VBZ	UH
JJR+:+IN+:+JJ	JJR
RB+:+NNS	NNS
CD+NN+NNS	CD
RP+:+IN+:+VB	JJ
VB+:+VBD	VBN
JJS+VBN	VBN
VB+:+JJ+:+JJ	JJ
VB+:+JJ	JJ
DT+JJ+NNS	RB
IN+DT+NNS	RB
DT+NNP+VBZ+NNP	NN
NN+NN+NNS	NNS
NNP+VBZ+NNP+NNP	NNP
